1111111111111111111111
10010C00011111000C0001
1000100C00111C00C00001
10C00C0P00110000100001
10CE010C00110001100001
10000100C0000001000001
10C0010000C00001000C01
1111111111111111111111