1111111111111111111111
10010C0M0111110M0C0001
1M00100C00111C00C00M01
10C00C0P00110M0010M001
10MEC00CM0110001100001
100M0100C0000001000001
10C0M10000CM00010M0C01
1111111111111111111111