1111111111111111111111
10010C00011111000C0001
1000100C00111C00C00001
10CC0C0P00110000100001
10CEC00C00110001100001
100C0100C0000001000001
10C0010000C00001000C01
1111111111111111111111