1111111111111111111111
10010C00011111000C0001
1000100C00111C00C00001
10C1000P00110000100001
10C0010C00110001100001
10000100C00000010E0001
10C0010000C00001000C01
1111111111111111111111