11111111
11100111
110C0001
1P0001M1
1E1001C1
11111111