1111111111
1000000001
1P00100001
1000011011
10001100E1
1111111111