11111
100011
10001
10001
11111