1111111111
1MC000C0M1
1PMC1M00C1
10C0011001
1CM011MCE1
1111111111