1111111111
10C000C001
1P0C1000C1
10C0011001
1C00110CE1
1111111111